111111111111111111111
100000000000000110111
10C100000000001110111
101C001001P0000010111
100000000011100010111
100110000000000010111
100010C00100000010111
100000000000001110001
1E010010C000000CC0111
101111111111110111111
100000000000000000011
111111111111111111111